wwwwwwwwwwwwwwwwwwwwwwwwwwwwwwwwwwwwwwww
w______________________________________w
w______________________________________w
w___|3-||3-||3-||3-||3-||3-||3-||3-|___w
w___|2-||2-||2-||2-||2-||2-||2-||2-|___w
w___|2-||2-||2-||2-||2-||2-||2-||2-|___w
w___|--||--||--||--||--||--||--||--|___w
w___|2-||2-||2-||2-||2-||2-||2-||2-|___w
w___|2-||2-||2-||2-||2-||2-||2-||2-|___w
w___|3-||3-||3-||3-||3-||3-||3-||3-|___w
w______________________________________w
w______________________________________w
w______________________________________w
w______________________________________w
w______________________________________w
w______________________________________w
w______________________________________w
w______________________________________w
w______________________________________w
w______________________________________w
w______________________________________w
w______________________________________w
w______________________________________w
w______________________________________w
w______________________________________w
w______________________________________w
w______________________________________w
w______________________________________w
w______________________________________w
w_|Q||W||E||R||T||Y||Q||W||E||R||T||Y|_w
w______________________________________w
w______________________________________w
w______________________________________w
w______________________________________w
w______________________________________w
w______________________________________w
w______________________________________w
w___________PPPPP______________________w
w______________________________________w
wwwwwwwwwwwwwwwwwwwwwwwwwwwwwwwwwwwwwwww