wwwwwwwwwwwwwwwwwwwwwwwwwwwwwwwwwwwwwwww
w______________________________________w
w______________________________________w
w______________________________________w
w______________________________________w
w______________________________________w
w______________________________________w
w______________________________________w
w______________________________________w
w______________________________________w
w______________________________________w
w______________________________________w
w______________________________________w
w______________________________________w
w______________________________________w
w______________________________________w
w______________________________________w
w______________________________________w
w______________________________________w
w______________________________________w
w______________________________________w
w______________________________________w
w______________________________________w
w______________________________________w
w______________________________________w
w______________________________________w
w______________________________________w
w______________________________________w
w_|Q||W||E||R||T||Y||Q||W||E||R||T||Y|_w
w_|Q||W||E||R||T||Y||Q||W||E||R||T||Y|_w
w______________________________________w
w______________________________________w
w______________________________________w
w______________________________________w
w______________________________________w
w______________________________________w
w______________________________________w
w___________PPPPP______________________w
w______________________________________w
wwwwwwwwwwwwwwwwwwwwwwwwwwwwwwwwwwwwwwww